*****************
*  XXE*         *
* *X*** ******* *
* *XXX* *     * *
* ***X* ***** ***
* *XXX*     *   *
* *X* ***** *** *
* *X*   * *     *
* *X*** * ***** *
* *XXX*       * *
* ***X***** *** *
* * *XXXXX* *   *
* * *****X*** ***
* * *XXXXX*   *S*
* * *X***** ***X*
*   *XXXXXXXXXXX*
*****************
