********
*E     *
**  *  *   
*S     *    
********

