*****************
*    E*         *
* * *** ******* *
* *   * *     * *
* *** * ***** ***
* *   *     *   *
* * * ***** *** *
* * *   * *     *
* * *** * ***** *
* *   *       * *
* *** ***** *** *
* * *     * *   *
* * ***** *** ***
* * *     *   *S*
* * * ***** *** *
*   *           *
*****************