********
*EX    *
**X *  *
*SX    *
********

